.......................................................................................###############################..........................................######..################....#####.............................................................##.####.#.....#...................##..........
.........................................................................................#############################.........................................#########################...#####..............................................................##.##.#.......#.##.................##........#
#......................#.................................................................###########.##.##############.........................................########################...######.................................................................#.###.#....#.##..................#.......##
#........................#................................................................#########..#################..........................................#######.##############....######.............................................................###...#.#.##....###..................#......##.
.........................#................................................................##########..################............................................###################.....######............................................................#..#.#####.#...###.#.........................##.
#....#.....................................................................................#######..#################............................................#######.############.....######.................................................................##.##.##...#.##..................##........
.#..........................................................................................######..#################.............................................#######.##########......#####.............................................................##.#...#.##.##.##.#.#..................#......#.
...........................................................................................#.####.#.#.###############............................................#.####..###########.......####......##.....................................................#.####.....#.#.#.####.............#....#........
...........................................................................................#.####.###.###############.............................................####.############.......#####......##...................................................#..###.....#.##..#..####............###...........
....#......................................................................................##.#######.###.##########...............................................#.##.#.##########......#####.....#..................................................###.....##.###.##.##.####.##............#.#..........
...........................................................................................########..###############...............................................###.#############......#####..........................................................#..##..##...##.#....#..#.#............###..........
.......................#...................................................................###.#####################...............................................#################......####........................................................######..##.#####...#.#..#.#.##............##..........
...........................................................................................#########################..............................................#.##.#..##########......####........................................................###....###....####.###...##.##........................
...........................................................................................#########.#############.................................................###.#############......####.......................................................#.##.###.##..#..#.#####..#....#........................
..........................#................................................................######################..................................................#.##.############......####.........................................................##.###.###.##.#.#..#######..##.......................
...........................................................................................####################.........................................................############......####.......................................................#.#######.##.....#..###.###..#.#.......................
............................................................................................#.#################....................................................##.#############.......####.......................................................#.###.##.#####.###.#.#.###.######......................
...........................................................................................##.################.....................................................###.###########.........##.........................................................###.#...#.########..#.###..##.##......................
...........................................................................................##.################.......................................................###.#########....................................................................#..####..#.#.#.#####.##..#.#..##......................
...........................................................................................###################.....................................................###..##########...................................................................#####...##..#.##.#....#.#....####......................
..........................................................................................####################.....................................................#.##.##########.....................................................................#######.###.###.#.#...###..####......................
..........................................................................................##..################..........................................................#.########....................................................................#####...#..#.#.#.#...##.##.#####......................
..........................................................................................##.#################......................................................#############....................................................................#..#.#.#..##.#..##.###.###.....##......................
..........................................................................................##.################........................................................############....................................................................#...####.###.#.####..###.#.######......................
..........................................................................................##.################.......................................................#.#D#.#######.....................................................................#.#....#.###..#.#.#.###....#.###......................
..........................................................................................###################.......................................................#.##.#######......................................................................#.##...#.#..##.####.###.#..#####......................
..........................................................................................###################.........................................................#.#..#####......................................................................#.#....#####....###....###..####......................
..........................................................................................##################.........................................................###.#######......................................................................###...######.#..#.####....######......................
..........................................................................................#################..........................................................#.#.#.####.......................................................................####.#####.......###.###########....#.................
..........................................................................................#################..........................................................#..#.#####.......................................................................#..#.#.#.........###.###.#.#####......................
..........................................................................................################...........................................................####.####........................................................................####.##..........####..##.#####.......................
..........................................................................................################...........................................................########........................................................................###.####..........####..#..#####.......................
..........................................................................................################...........................................................#######.........................................................................####...............##.##..#.####.......................
..........................................................................................################...........................................................###.............................................................................####...............##.##.####.#..................#.....
.........................................................................................################..............................................................................................................................................##...............#####..#####..................#.....
.........................................................................................##############..................................................................................................................................................................##.########..................##....
.........................................................................................###.##########.....................................................................................................................................................................########..................##....
.........................................................................................#####.########....................................................................................................................................................................#..#####....................##...
........................................................................................###############....................................................................................................................................................................########....................##...
........................................................................................####.#..#######....................................................................................................................................................................########....................###..
........................................................................................####.##.#######....................................................................................................................................................................#######.....................###..
........................................................................................#######.######.....................................................................................................................................................................######......................####.
........................................................................................#######.#####..........................................................................................................................................................................#.......................####.
........................................................................................######.####...................................................................................................................................................................................................####..
........................................................................................#######..##....................................................................................................................................................................................................###..
........................................................................................##########......................................................................................................................................................................................................#...
........................................................................................###..#..##.............................................................................................................................................................................###...................####...
........................................................................................###.##.................................................................................................................................................................................###...................###....
........................................................................................######.#...............................................................................................................................................................................##...................###.....
........................................................................................#####.###...............................................................................................................................................................................##..................##......
........................................................................................#########...............................................................................................................................................................................##..........................
........................................................................................#.#..###...............................................................................................................................................................................###...................#......
.......................................................................................##.#....#................................................................................................................................................................................#...................###.....
............................................................................................#.......................................................................................................................................................................................................#.......
.........................................................................................#.####...................................................................................................................................................................................................#.#.......
.........................................................................................##.###...................................................................................................................................................................................................###.......
.........................................................................................###.#....................................................................................................................................................................................................###.......
.........................................................................................###.#...................................................................................................................................................................................................####.......
...........................................................................................#.....................................................................................................................................................................................................###........
.........................................................................................##.#...............................................................................................................................................................................................................
.........................................................................................####...............................................................................................................................................................................................................
.........................................................................................#..#.#.............................................................................................................................................................................................................
.........................................................................................#####..............................................................................................................................................................................................................
.........................................................................................##.................................................................................................................................................................................................................
........................................................................................#...#...............................................................................................................................................................................................................
...........................................................................................#................................................................................................................................................................................................................
............................................................................................................................................................................................................................................................................................................
..........................................................................................##................................................................................................................................................................................................................
.........................................................................................####...............................................................................................................................................................................................................
.........................................................................................####...............................................................................................................................................................................................................
.........................................................................................####...............................................................................................................................................................................................................
.........................................................................................####...............................................................................................................................................................................................................
...........................................................................................##...............................................................................................................................................................................................................
............................................................................................................................................................................................................................................................................................................
............................................................................................#...............................................................................................................................................................................................................
